Androgen metabolism from L Schiffer

[-:-]	This database type is not implemented yet: Uniprot-SwissProt; resource: P26439
[-:-]	This database type is not implemented yet: Uniprot-SwissProt; resource: P26439
[-:-]	This database type is not implemented yet: Uniprot-SwissProt; resource: P26439
[-:-]	This database type is not implemented yet: Uniprot-SwissProt; resource: P26439
[CATALYSIS:id33064d39]	Interaction is not connected
[CONVERSION:id5ceadaa4]	Interaction is not connected
[CATALYSIS:id7b022a11]	Interaction is not connected
[CONVERSION:ide37cde18]	Interaction is not connected
[CONVERSION:f9dda]	Interaction is not connected
[CONVERSION:f9cfa]	Interaction is not connected
[CONVERSION:e9b1b]	Interaction is not connected
[CATALYSIS:id67ff12b4]	Interaction edge is invalid (one end is not connected).
[CATALYSIS:idf9af1a95]	Interaction edge is invalid (one end is not connected).
[CATALYSIS:idb2f500d8]	Interaction edge is invalid (one end is not connected).
[CATALYSIS:idf4869e51]	Interaction edge is invalid (one end is not connected).
[Complex:baddc]	Empty element is invalid
[Complex:d8fde]	Empty element is invalid
[Complex:aaaf9]	Empty element is invalid
[Complex:b936c]	Empty element is invalid
[Complex:fbec8]	Empty element is invalid
[Complex:ca946]	Empty element is invalid
[Complex:b6603]	Empty element is invalid
[Complex:deedf]	Empty element is invalid
[Complex:c0efc]	Empty element is invalid
[Complex:a5564]	Empty element is invalid
[Complex:d105b]	Empty element is invalid
[Complex:f0c92]	Empty element is invalid
[Complex:b8280]	Empty element is invalid
[Complex:fb2ce]	Empty element is invalid
[Complex:bd7f9]	Empty element is invalid
